1111111111
1P00E00001
10C0000001
1000000001
1000000001
1111111111