111111
1P00E1
100001
100001
101101
101101
100C01
111111