11111111
1000C001
1000P001
10000000
10C00001
100000E1
11111111