111111
1P11E1
101101
101101
101101
100001
111C11
111111