111111111
100000001
100P00001
100000001
10C0000E1
111111111