1111111111
1000000P01
100000C111
1111101111
11E0000001
1111111111